20
15
GGWWWWWWTTTTTTTTTTTT
GGGGGGGGGGGGGTTTTTTT
GGGGGGGGGGGGGGGGTTTT
GGGGGGGGGWWGGGGGGGGT
GGGGGRGGPPPPGGGGGGGG
GGGGGGGGPGGPGGGGGGGG
GGGGGGGGPPGPGGGGGGGG
GPPPPPPGGPGPPPPPPPPE
GPGGGGPGGPGGGGGGGGGG
GPGGGGPGGPGGGGGGGGGT
SPGGGGPGGPGGGGGGGGTT
GGGGGGPGGPGGRGGGGTTT
GGGGGGPPPPGGGGGTTTTT
GGGGGGGGGGTTTTTTTTTT
GGTTWWWWWWTTTTTTTTTT
