20
20
GGGGGGGGGGGGGGGGGGGG
GGGGGGGGGGGGGGGGGGGG
GRGGGGGGGGGGGGGGGGGG
GGGGGGGGGRGGRGGGGGGG
GGGGGGGGGRGGGGGGGGGG
GGGGGGGGGGGGGGGGGGGG
GGGTTGGGGGGGGGGGGGGG
GGGTSPPPPPPPPPPPPEGG
GGGTTGGGGGGGGGGGGTGG
GGGGGGGGGGGGGGGGTGGG
GGGGGGGGGGGGGGGGGGGG
GGGGGRGGTGGGGGGGGGGG
GGGGGGGGGRGGGGGGGGGG
GGGGGGGGGGGGGGGGGGGG
GGGGGGGGGGGRGGGGGGGG
GGGGGGGGGGGGGGGGGGGG
GGGGGGGGGGGGGGGGGGGG
GGGGGGGGGGGGGGGGGGGG
GGGGGGGGGGGGGGGGGGGG
GGGGGGGGGGGGGGGGGGGG
