20
20
GGGGGGGGGGGGGGGGGGGG
GGGGGGGGGGGGGGGGGGGG
GGGGGGGGGGGGGGGGGGGG
GGSPGGGGGGGGGGGGGGGG
GGGPGGGGGGGGGGGGGGGG
GGGPGPPPPGGGGGGGGGGG
GGGPPPGGPGGGGGGGGGGG
GGGGGGGGPGGGGGGGGGGG
GGGGGGGGPGGEGGGGGGGG
GGGGGGGGPGGPGGGGGGGG
GGGGGGGGPGGPGGGGGGGG
GGGGGGGGPGPPGGGGGGGG
GGGGGGGGPGPGGGGGGGGG
GGGGGGGGPPPGGGGGGGGG
GGGGGGGGGGGGGGGGGGGG
GGGGGGGGGGGGGGGGGGGG
GGGGGGGGGGGGGGGGGGGG
GGGGGGGGGGGGGGGGGGGG
GGGGGGGGGGGGGGGGGGGG
GGGGGGGGGGGGGGGGGGGG
