18
18
GGGGGGGGGGGGGGGGGG
GGGGGGGGGRGGGGGGGG
GGTTTTTTTRGGGGGGGG
GGTSTSTSTRGGGGGGGG
GGTPPPPPTRGGGGGGGG
GGTTRPRTRGGGGGGGGG
GGGWGPGWGGGGGGGGGG
GGGWGPGWGGGGGGGGGG
GGGWGPGWGGGGGGGGGG
GGGWGPGWGGGGGGGGGG
GGGWGPGWGGGGGGGGGG
GGGWGPGWGGGGGGGGGG
GGGWGEGWGGGGGGGGGG
GGGWGGGWGGGGGGGGGG
GGGWWWWWGGGGGGGGGG
GGGGGGGGGGGGGGGGGG
GGGGGGGGGGGGGGGGGG
GGGGGGGGGGGGGGGGGG
