15
15
GGGGGGGGGGGGGGG
GGGGTTTTGGGGGGG
GGGTGGGTGGGGGGG
GGGTGSGTGGGGGGG
GGGTGPGTGTGGGGG
GGGTGPGTGGGGGGG
GGGTGPGTGGGGGGG
GGGTGPGTGGGGGGG
GGGTGPGTGGGGGGG
GGGTGPGTGGGGGGG
GGGTGPGTGGGGGGG
GGGTGEGTGGGGGGG
GGGTGGGTGGGGGGG
GGGTTTTTGGGGGGG
GGGGGGGGGGGGGGG
