20
20
GGGGGGGGGGGGGGGGGGGG
GGGGGPPPPPPPGGGGGGGG
GGGGGPGGGGGPPGGGGGGG
GGGGGPGGGGGGPPGGGGGG
GGGGGPGPPPGGGPGGGGGG
SPPPGPPPGPGGGPGGGGGG
GGGPGGGGGPGGGPGGGGGG
GGGPPPPPPPGGGPGGGGGG
GGGGGGGGGGGGGPGGGGGG
GGGGGGGGGGGGGPGGGGGG
GGGGGGGGPPPPPPGGGGGG
GGGGGGGGPGGGGGGGGGGG
GGGGGGGGPGGGGGGGGGGG
GGGGGGGGPGGGGGGGGGGG
GGGGGGGGPGGGGGGGGGGG
GGGGGGGGPGGGGGGGGGGG
GGGGGGGGPPPPPPPPPEGG
GGGGGGGGGGGGGGGGGGGG
GGGGGGGGGGGGGGGGGGGG
GGGGGGGGGGGGGGGGGGGG
