10
10
GGGGRGGTGG
GGGGSTPPPG
GGGGPGPRPG
GGGGPGTGPG
GGGGPGTGPG
GGGGPRPGPG
GGGGPPPTPG
GGGGTGGGEG
GGGGGTGGRG
GGGGGGGGGG
